11111111111111111111111111111111111111111111111111
1P0000000000000000000000CC000100000000000000000001
10000000000C000000001000000000000000000000000000E1
10000000000C00000000100000000C000000000000000000C1
10000000000C00000000100000000C000000000000000000C1
10000000000C00000000100000000C000000000000000000C1
10000000000C00000000100000000C000000000000000000C1
10000000000C00000000100000000C000000000000000000C1
10000000000C00000000100000000C000000000000000000C1
10000000000C00000000100000000C000000000000000000C1
10000000000C00000000100000000C000000000000000000C1
10000000000C00000000100000000C000000000000000000C1
10000000000C00000000100000000C000000000000000000C1
10000000000C00000000100000000C000000000000000000C1
10000000000C00000000100000000C000000000000000000C1
10000000000C00000000100000000C000000000000000000C1
10000000000C00000000100000000C000000000000000000C1
10000000000C00000000100000000C000000000000000000C1
10000000000C00000000100000000C000000000000000000C1
10000000000C00000000100000000C000000000000000000C1
10000000000C00000000100000000C000000000000000000C1
10000000000C00000000100000000C000000000000000000C1
10000000000C00000000100000000C000000000000000000C1
10000000000C00000000100000000C000000000000000000C1
10000000000C00000000100000000C000000000000000000C1
10000000000C00000000100000000C000000000000000000C1
11111111111111111111111111111111111111111111111111
