11111111111111111111111111111111111111111111111111
1P0000000000000000000000000000000000000000000000C1
11111111111111111111111111110111111111111111111111
10000000000000000000000000000000000000000000000001
111111111111111111111111111C0C11111111111111111111
10000000000000000000000000000000000000000000000001
111111110C1111111111111111111111111111111111111111
10000000000000000000000000000000000000000000000001
10111111111111111111111111111111111111111111111111
10000000000000000000000000000000000000000000000001
11111111111111111111111011111111111111111111111111
10000000000000000000000000000000000000000000000001
1111111111C110111111111111111111111111111111111111
10000000000000000000000000000000000000000000000001
111111111C1110111111111111111111111111111111111111
10000000000000000000000000000000000000000000000001
11111111111110111111111111111C11111C11111111111111
10000000000000000000000000000000000000000000000001
11111111111110111111111111111111111C11111111111111
10000000000000000000000000000000000000000000000001
1111111111111C101111111111111111111111111111111111
10000000000000000000000000000C00000000000000000001
111111111111C1101111111111111111111111111111111111
10000000000000000000000000000000000000000000000001
10000000000000000000000000000000000000000000000001
1E0000000000000000000000000000000000000000000000C1
11111111111111111111111111111111111111111111111111