11111111111111111111111
10000000000100000000001
10111011110101111011101
10111011110101111011101
10000000000C00000000001
10111010111111101011101
10000010000100001000001
11111011110001111011111
11111010000000001011111
11111010010001001011111
1000000001P0E1000000001
11111010011111001011111
11111010000000001011111
11111010111111101011111
10000000000100000000001
10111011110101111011101
10001000000000000010001
11101010111111101010111
1000001000C100001000001
10111111110101111111101
100000000000000000000C1
11111111111111111111111