1111111111111
10000000001C1
1101011110111
1P001E0000001
1111111111111
