1111111111111
1P000E00C00 1
1111111111111
