1111111111111
10000000000C1
1101010111001
1101010111001
1101010111001
1101010111001
1101010111001
1101010111001
1101010111001
1101010111001
1101010111001
1101010111001
1101010111001
1101010111001
1101010111001
1101010111001
1101010111001
1101010111001
1101010111001
1101010111001
1101010111001
1101010111001
1101010111001
1101010111001
1101010111001
1101010111001
1101010111001
1101010111001
1101010111001
1101010111001
1101010111001
1101010111001
1101010111001
1101010111001
1101010111001
1101010111001
1101010111001
1101010111001
1101010111001
1101010111001
1101010111001
1101010111001
1101010111001
1101010111001
1P001E0100001
1111111111111
