1111111111111
10000000000P1
1101011111111
1000100000001
1000000000001
1000000000001
1000000000001
1000000000001
1000000000001
100000000E001
1000000000001
1000000000001
1000000000001
1000000000001
1000000100001
1000000111101
1000000100001
10000001C1111
1000000010001
1111111111111