1111111111111
1000000000001
1101111111001
10010ECP00001
1111111111111
