1111111111111
1CCCCCCCCCCC1
11C1111111CC1
1CC1CECPCCCC1
1111111111111
