1111111111110
10000000000C1
1101011111001
1P001E0100001
1111111111111
