1111111111111
1000000000001
1101011111001
1P001E0100001
1111111111111
