1111111111111
1000000000001
1101011111001
1P001E0000001
1111111111111
