1111111111111
10000000000C0
1101011111001
1P001E0100001
1111111111111
